110100 北京市
310100 上海市
320100 南京市
420100 武汉市
440100 广州市
440300 深圳市
441300 惠州市
442000 中山市